*****************************
*S                         G *
*                           *
*                           *
*  **************************
*                           *
*  **************************
*  *                        *
*  *                        *
*  *                        *
****                        *
*                           *
*****************************